20
8
1
7
0
0
0
0
0
8
1
10
1
####################
#       S#S        #
#A       #########R#
#        #T     F  #
#        #FF    T  #
#        #U#########
#       H#        G#
####################