15
20
1
1
11
2
4
3
15
1
15
1
17
###############
#             #
#             #
#         #F# #
#    #B#  #C#H#
###### ########
#   E#        #
#    # ###### #
#    # ######I#
#W#### ########
#             #
##########D####
##### #### ## #
#             #
#             #
#S            #
###############
#S#    #      #
# # #  # #  # #
#   #    #  #G#
###############