20
8
1
6
0
0
0
2
1
3
0
0
8
1
10
1
####################
#I     WS#S        #
#      WW#########R#
#A########T     F  #
#        #FF    T  #
######## #U#########
#       H#        G#
####################