20
10
1
8
0
0
0
13
3
1
3
0
0
8
2
10
2
####################
#    W    #        #
#    W  S # S      #
#I   W    #        #
#    WWWW#########R#
#A########T     F  #
#        #FF T  T  #
######## #3#########
#       H#        G#
####################