33
8
1
1
15
5
3
21
5
3
0
0
4
3
31
5
#################################
# ###########WWWGWWW#I          #            
# #     E   #WWWWWWW##### ###   #            
# # S ##### #WWWWWWW#       #   #
# #   #     #       ######D##   #
# ###FFF#####       W       # S #
#          H#       W       #   #
#################################