32
8
1
1
15
5
3
21
5
3
0
0
3
4
30
6
################################
# #   #######WWWGWWW#I         #            
# # #   E   #WWWWWWW##### ###  #            
# # ####### #WWWWWWW#       #  #
# #S#       #       ######D##  #
# ###FFF#####       W       # S#
#          H#       W       #  #
################################