15
21
1
1
11
2
4
1
13
1
5
15
2
14
2
18
###############
#             #
#             #
#         #F# #
#    #B#  #C#H#
###### ########
#WWWE#        #
#WWWW# ###### #
#WWWW# ######I#
#W#### ########
#             #
##########D####
#             #
#             #
# S           #
#             #
###############
#      #      #
# S  # # #  # #
#    #   #  #G#
###############