32
8
1
1
0
0
0
0
0
3
4
30
6
################################
# #   #######                  #            
# # #       #                  #            
# # ####### #                  #
# #S#       #                  #
# ###FFF#####                  #
#          H#                 S#
################################