15
21
1
1
11
2
4
1
13
1
3
15
1
15
1
17
###############
#             #
#             #
#         #F# #
#    #B#  #C#H#
###### ########
#WWWE#        #
#WWWW# ###### #
#WWWW# ######I#
#W#### ########
#             #
##########D####
##### #### ####
#             #
#             #
#S            #
###############
#S#    #      #
# # #  # #  # #
#   #    #  #G#
###############