15
21
13
19
3
16
3
1
14
1
0
0
0
0
0
0
###############
#GWWW    #    #
#WWWW    #### #
#WWWW    #    #
#WWWW    # ####
#           ###
###B###R###D###
#I# # # # # # #
# #           #
# #####  # ####
#        # ##E#
#####    # ## #
#        #    #
#U#############
#            T#
#             #
#   T         #
#        # #  #
#        # ####
#        #    #
###############