15
21
13
19
3
16
3
6
14
4
0
0
0
0
0
0
###############
#GWWW    #    #
#WWWW    #### #
#WWWW    #    #
#WWWW    # ####
#           ###
###B###R###D###
#I# # # # # # #
# #           #
# #####  # ####
#        # ##E#
#####    # ## #
#        #    #
#2#############
#            T#
#   T         #
#             #
#        # #  #
#        # ####
#        #    #
###############