20
10
1
8
18
2
4
7
4
1
0
0
0
0
0
0
####################
####################
##########W       F#
#                  #
#                  # 
#                  #
#                  #
#                  #
#                 G#
####################