20
10
1
8
18
8
4
18
1
2
0
0
8
2
12
2
####################
#A   R    2        #
#    #  A #    T   #
#R#########        #
#  W H  FF#  T     #
#I W    FG#        #
##################D#
### ## ##E## ## ## #
#                  #
####################